#####___
######__
#######_
########
########
_#######
__######
___#####