_######_
########
########
###__###
###__###
########
########
_######_