1;20;1;3;2;7;7;7
2;20;5;6;4;10;15;10
3;15;4;1;3;10;2;10
4;22;4;5;6;12;12;12
5;20;2;1;6;4;10;15