20000002
17000073
34500131
13646513
04313450
00654100
00056000
00022000