_##__##_
########
########
_######_
_######_
########
########
_##__##_