00345600
00412300
14723756
63254121
23263665
25412516
00753700
00226200